6 10
3
0 1 -1 0 2 -1 0 1 -1 -1 -1 -1 -1 -1 -1 3 0 -1 1 3 -1 2 3 -1 -1 -1 -1 -1 -1 -1
-1 -1 -1 -1 -1 -1 1 3 -1 2 3 -1 1 3 -1 1 2 3 1 3 -1 0 1 3 1 2 -1 -1 -1 -1
-1 -1 -1 -1 -1 -1 1 2 -1 0 2 3 -1 -1 -1 -1 -1 -1 -1 -1 -1 -1 -1 -1 1 3 -1 -1 -1 -1
-1 -1 -1 -1 -1 -1 -1 -1 -1 3 0 -1 2 0 -1 1 2 3 0 1 2 1 3 -1 1 2 3 -1 -1 -1
-1 -1 -1 -1 -1 -1 -1 -1 -1 -1 -1 -1 -1 -1 -1 1 2 -1 1 2 3 1 3 -1 2 3 0 1 3 -1
-1 -1 -1 -1 -1 -1 -1 -1 -1 -1 -1 -1 -1 -1 -1 -1 -1 -1 -1 -1 -1 -1 -1 -1 -1 -1 -1 -1 -1 -1